NO ./image/384/no.xpm
WE ./image/384/we.xpm
SO ./image/384/so.xpm
EA ./image/384/ea.xpm

F  100,   205,  150
C 155,200,42

11111111          
10010001          
11000011111111111       11111
100N0100000000001       100001
11111111111111111       11111
 
11111111111111111
10010000000001111
11111111111111
