NO ./image/384/no.xpm
WE ./image/384/we.xpm
SO ./image/384/so.xpm
EA ./image/384/ea.xpm
F 220,100,0
C 225,30,0



 11111
100E001
 11111