NO ./image/384/no.xpm
WE ./image/384/we.xpm
SO ./image/384/so.xpm
EA ./image/384/ea.xpm

F  100,   205,  150
C 155,200,42

11111111          
10010001          
11000011111111111
100N0000000000001
10010000000001111
11111111111111
