NO ./image/no.xpm
WE ./image/we.xpm
SO ./image/so.xpm
EA ./image/ea.xpm
F 100,205,150
C 155,200,42

1111
1N01
1111
