NO ./path_to_the_north_texture
SO ./path_to_the_south_texture
WE ./path_to_the_west_texture
EA ./path_to_the_east_texture
F 100,205,150
C 155,200,50


111111
100101
1000011111111111
100N000000000001
1000000000011111
111111111111