NO ./image/small/no.xpm
WE ./image/small/we.xpm
SO./image/small/so.xpm

EA ./image/small/ea.xpm

F  110, 44, 0
C  247, 220, 111

111111111111
100000000001
10000N100001
101000000001
111111111111