NO ./image/384/no2.xpm
WE ./image/384/we2.xpm
SO ./image/384/so2.xpm
EA ./image/384/ea2.xpm

F  100,   205,  150
C 155,200,42

111111          
100101          
1100011111111111
100N100000000001
1010000000011111
111111111111
