11111
1000111
1PCE001
1000001
111111