   1111
11110001111
1PC00E000001
1000000000001     
10000000000001
100000000000001
111100111111111
   1111