   1101
11110001111
1PC00E000001
0000000000001     
10000000000000
100000000000001
111100111011111
   1111