11111111111111
10000C000001E1
10100011010101
1010001P110101
1C000000000101
10000000100101
10100011C10101
10000010000001
11111111111111