NO ./path_to_the_north_texture
SO ./path_to_the_south_texture
WE ./path_to_the_west_texture
EA ./path_to_the_east_texture
F 100,205,150
C 155,200,50


111111
100101
101001111111
100000000001
10000000W001
111111111111